10 8 100
1 1 1 1 1 1 1 1 1 1
1 0 0 0 0 0 0 0 0 1
1 0 1 0 1 1 1 0 0 1
1 0 1 1 0 0 0 0 0 1
1 0 0 0 0 0 1 0 0 2
1 0 0 0 0 0 0 0 0 1
1 0 0 0 0 0 0 0 0 1
1 1 1 1 1 1 1 1 1 1
NULL NULL maps/map2.txt NULL
0